+.+++++...+.....+.
+.+...+++++...+...
+...+.+++++++...+.
+.+.+.+++++.++.+..
++.++...........+.
+++++++++++++++.+.
................++
+++++++++++++.....