..+++++...+.....+.
+.+...+++++...+...
+...+.+++++++...+.
+.+.+.+++++.++.+..
++.++.......+...+.
+++++++++++++++.+.
................++
+++++++++++++.....